{
  "A": {
    "w": 40,
    "h": 20,
    "data": [
      "0000000000000000000000000000000000000000",
      "0000000000000000000000000000000000000000",
      "0000000000000000000000000000000000000000",
      "0000000000000000000000000000000000000000",
      "0000000000000000000000000000000000000000",
      "1111111111000000000000000000001111111111",
      "0000000000000000000000000000000000000000",
      "0000000000000000000000000000000000000000",
      "0000000000000000000000000000000000000000",
      "0000000000000001111111111000000000000000",
      "0000000000000000000000000000000000000000",
      "0000000000000000000000000000000000000000",
      "0000000000000000000000000000000000000000",
      "0000000000000000000000000000000000000000",
      "1111111111000000000000000000001111111111",
      "0000000000000000000000000000000000000000",
      "0000000000000000000000000000000000000000",
      "0000000000000000000000000000000000000000",
      "0000000000000000000000000000000000000000",
      "0000000000000000000000000000000000000000"
    ]
  }
}